%%%%%%%%
%%%   P%
%%%  %%%
%%%% %%%
%.   %%%
%%%%%%%%